979,494,42,42,-2,0,0,0
1029,494,42,42,-2,0,0,0
1079,494,42,42,-2,0,0,0
1200,494,42,42,-2,0,0,0
1250,494,42,42,-2,0,0,0
1300,494,42,42,-2,0,0,0
1766,494,42,42,-2,0,0,0
1816,494,42,42,-2,0,0,0
2907,494,42,42,-2,0,0,0
2957,494,42,42,-2,0,0,0
3007,494,42,42,-2,0,0,0
4552,494,42,42,-2,0,0,0
4602,494,42,42,-2,0,0,0
4652,494,42,42,-2,0,0,0
5180,494,42,42,-2,0,0,0
5230,494,42,42,-2,0,0,0
5280,494,42,42,-2,0,0,0
5430,494,42,42,-2,0,0,0
5480,494,42,42,-2,0,0,0
5530,494,42,42,-2,0,0,0