789,494,42,42,-2,0,0,0
2660,494,42,42,-2,0,0,0
5006,494,42,42,-2,0,0,0
7233,494,42,42,-2,0,0,0
7422,494,42,42,-2,0,0,0
4126,484,42,42,-2,0,0,0
4216,494,42,42,-2,0,0,0
6133,494,42,42,-2,0,0,0
6233,494,42,42,-2,0,0,0
10681,494,42,42,-2,0,0,0
10881,494,42,42,-2,0,0,0
11217,494,42,42,-2,0,0,0
11317,494,42,42,-2,0,0,0
14010,494,42,42,-2,0,0,0