839,494,42,42,-2,0,0,0
780,494,42,42,-2,0,0,0
2266,494,42,42,-2,0,0,0
2216,494,42,42,-2,0,0,0
2166,494,42,42,-2,0,0,0
2116,494,42,42,-2,0,0,0
4190,494,42,42,-2,0,0,0
4090,494,42,42,-2,0,0,0
5371,494,42,42,-2,0,0,0
5300,494,42,42,-2,0,0,0
6778,494,42,42,-2,0,0,0
6728,494,42,42,-2,0,0,0
