839,507,42,42,-2,0,0,0
780,507,42,42,-2,0,0,0
2266,507,42,42,-2,0,0,0
2216,507,42,42,-2,0,0,0
2166,507,42,42,-2,0,0,0
2116,507,42,42,-2,0,0,0
4190,507,42,42,-2,0,0,0
4090,507,42,42,-2,0,0,0
5371,507,42,42,-2,0,0,0
5300,507,42,42,-2,0,0,0
6778,507,42,42,-2,0,0,0
6728,507,42,42,-2,0,0,0
