972,494,42,42,-2,0,0,0
1720,494,42,42,-2,0,0,0
2206,494,42,42,-2,0,0,0
2255,494,42,42,-2,0,0,0
3433,182,42,42,-2,0,0,0
3485,182,42,42,-2,0,0,0
4153,494,42,42,-2,0,0,0
4196,494,42,42,-2,0,0,0
4906,494,42,42,-2,0,0,0
4950,494,42,42,-2,0,0,0
5378,494,42,42,-2,0,0,0
5424,494,42,42,-2,0,0,0
5486,494,42,42,-2,0,0,0
5532,494,42,42,-2,0,0,0
7435,494,42,42,-2,0,0,0
7482,494,42,42,-2,0,0,0
