920,367,42,42,-2,0,0,0
962,367,42,42,-2,0,0,0
1004,367,42,42,-2,0,0,0
4930,537,42,42,-2,0,0,0
4990,537,42,42,-2,0,0,0
6961,367,42,42,-2,0,0,0
7003,367,42,42,-2,0,0,0
8055,367,42,42,-2,0,0,0