1591,367,42,42,-2,0,0,0
1633,367,42,42,-2,0,0,0
5738,367,42,42,-2,0,0,0
5788,367,42,42,-2,0,0,0
8005,367,42,42,-2,0,0,0
8105,367,42,42,-2,0,0,0
8496,537,42,42,-2,0,0,0
8538,537,42,42,-2,0,0,0