1212,507,42,42,-2,0,0,0
1373,507,42,42,-2,0,0,0
2550,507,42,42,-2,0,0,0
2625,507,42,42,-2,0,0,0
3755,507,42,42,-2,0,0,0
3700,507,42,42,-2,0,0,0
5385,507,42,42,-2,0,0,0
5551,507,42,42,-2,0,0,0