1212,494,42,42,-2,0,0,0
1373,494,42,42,-2,0,0,0
2550,494,42,42,-2,0,0,0
2625,494,42,42,-2,0,0,0
3755,494,42,42,-2,0,0,0
3700,494,42,42,-2,0,0,0
5385,494,42,42,-2,0,0,0
5551,494,42,42,-2,0,0,0
7050,494,42,42,-2,0,0,0
7100,494,42,42,-2,0,0,0
7150,494,42,42,-2,0,0,0
7200,494,42,42,-2,0,0,0